Rang,Gewählter Beruf,Total,Anteil in %,Frauen,Männer
,"Total",7735,100.00,3446,4289
1,"Kaufmann/Kauffrau Erw. Grundbildung (E-Profil)",1505,19.46,943,562
2,"Detailhandelsfachmann/-frau Beratung EFZ",459,5.93,255,204
3,"Fachmann/-frau Gesundheit EFZ",386,4.99,341,45
4,"Elektroinstallateur/in EFZ",319,4.12,4,315
5,"Fachmann/-frau Betreuung (Kinderbetreuung) EFZ",238,3.08,223,15
6,"Kaufmann/Kauffrau Basisbildung (B-Profil)",219,2.83,128,91
7,"Koch/Köchin EFZ",207,2.68,59,148
8,"Polymechaniker/in EFZ",200,2.59,4,196
9,"Dentalassistent/in EFZ",153,1.98,146,7
10,"Zeichner/in (Architektur) EFZ",134,1.73,37,97
11,"Logistiker/in EFZ",133,1.72,21,112
12,"Coiffeur/-euse EFZ",122,1.58,111,11
13,"Med. Praxisassistent/in EFZ",116,1.50,115,1
14,"Detailhandelsassistent/in EBA",110,1.42,72,38
15,"Automobil-Fachmann/-frau (Personenwagen) EFZ",106,1.37,5,101
16,"Fachmann/-frau Betriebsunterhalt EFZ",99,1.28,2,97
17,"Informatiker/in (Systemtechnik) EFZ",97,1.25,6,91
18,"Schreiner/in (Möbel/Innenausbau)",96,1.24,7,89
19,"Pharma-Assistent/in EFZ",93,1.20,87,6
20,"Automatiker/in EFZ",92,1.19,2,90
20,"Maurer/in EFZ",92,1.19,1,91
20,"Sanitärinstallateur/in EFZ",92,1.19,0,92
20,"Zimmermann/Zimmerin",92,1.19,1,91
24,"Detailhandelsfachmann/-frau  Bewirtschaftung EFZ",85,1.10,45,40
25,"Konstrukteur/in EFZ",84,1.09,4,80
26,"Informatiker/in (Applikationsentwicklung) EFZ",83,1.07,7,76
27,"Automobil-Mechatroniker/in (Personenwagen) EFZ",81,1.05,2,79
28,"Gärtner/in (Garten- u. Landschaftsbau)",72,0.93,6,66
29,"Restaurationsfachmann/-frau EFZ",71,0.92,55,16
30,"Maler/in",67,0.87,29,38
31,"Elektroniker/in EFZ",66,0.85,6,60
32,"Informatiker/in (Generalistische Ausbildung) EFZ",55,0.71,4,51
33,"Assistent/in Gesundheit und Soziales EBA",53,0.69,50,3
33,"Logistiker/in EBA",53,0.69,7,46
35,"Fachmann/-frau Betreuung (Betagtenbetreuung) EFZ",52,0.67,45,7
36,"Montage-Elektriker/in EFZ",50,0.65,0,50
37,"Hotelfachmann/-frau EFZ",49,0.63,40,9
37,"Zeichner/in (Ingenieurbau) EFZ",49,0.63,18,31
39,"Bäcker-Konditor-Confiseur/-in EFZ",46,0.59,36,10
40,"Informatiker/in (Support) EFZ",41,0.53,5,36
41,"Heizungsinstallateur/in EFZ",40,0.52,1,39
42,"Drogist/in EFZ",39,0.50,36,3
42,"Metallbauer/in EFZ",39,0.50,2,37
44,"Augenoptiker/in EFZ",36,0.47,30,6
45,"Coiffeur/-euse EBA",33,0.43,28,5
45,"Florist/in EFZ",33,0.43,32,1
47,"Fachmann/-frau Betreuung (Generalist. Ausb.) EFZ",31,0.40,28,3
48,"Produktionsmechaniker/in EFZ",29,0.37,2,27
49,"Automobil-Fachmann/-frau (Nutzfahrzeuge) EFZ",28,0.36,0,28
49,"Landwirt/in EFZ",28,0.36,2,26
51,"Anlagen- und Apparatebauer/in",27,0.35,0,27
51,"Mediamatiker/in EFZ",27,0.35,8,19
51,"Spengler/in EFZ",27,0.35,1,26
54,"Büroassistent/in EBA",26,0.34,16,10
54,"Geomatiker/in EFZ",26,0.34,6,20
56,"Elektroplaner/in EFZ",24,0.31,5,19
57,"Automobil-Assistent/in EBA",22,0.28,1,21
57,"Bekleidungsgestalter/in (Damenbekleidung)",22,0.28,22,0
57,"Carrossier/in Lackiererei EFZ",22,0.28,4,18
60,"Bäcker-Konditor-Confiseur/-in EBA",21,0.27,17,4
60,"Carrossier/in Spenglerei EFZ",21,0.27,1,20
60,"Hauswirtschaftspraktiker/in EBA",21,0.27,16,5
60,"Landmaschinenmechaniker/in EFZ",21,0.27,0,21
64,"Forstwart/in EFZ",20,0.26,1,19
65,"Drucktechnologe/-login EFZ",19,0.25,8,11
66,"Automobil-Mechatroniker/in (Nutzfahrzeuge) EFZ",18,0.23,1,17
66,"Fachmann/-frau Hauswirtschaft EFZ",18,0.23,18,0
66,"Gärtner/-in EBA (Garten-und Landschaftsbau)",18,0.23,1,17
66,"Multimediaelektroniker/in",18,0.23,2,16
70,"Fleischfachmann/-frau EFZ",17,0.22,4,13
70,"Haustechnikpraktiker/in EBA",17,0.22,0,17
70,"Laborant/in (Chemie) EFZ",17,0.22,5,12
70,"Tiermed. Praxisassistent/in EFZ",17,0.22,16,1
74,"Laborant/in (Biologie) EFZ",15,0.19,2,13
74,"Schreinerpraktiker/in EBA",15,0.19,1,14
76,"Informatikpraktiker/in EBA",14,0.18,2,12
77,"Fachmann/-frau Betreuung (Behindertenbetreung) EFZ",13,0.17,11,2
77,"Gebäudetechnikplaner/in Heizung EFZ",13,0.17,0,13
77,"Gebäudetechnikplaner/in Lüftung EFZ",13,0.17,0,13
77,"Küchenangestellte/r EBA",13,0.17,3,10
77,"Mechanikpraktiker/in EBA",13,0.17,0,13
77,"Schreiner/in (Bau/Fenster)",13,0.17,0,13
83,"Automatikmonteur/in EFZ",12,0.16,0,12
83,"Buchhändler/in EFZ",12,0.16,11,1
83,"Fotofachmann/-frau EFZ (Fotografie)",12,0.16,10,2
83,"Innendekorateur/in",12,0.16,9,3
83,"Netzelektriker/in",12,0.16,0,12
83,"Verkehrswegbauer/in: Strassenbauer/in",12,0.16,0,12
83,"Zeichner/in (Raumplanung) EFZ",12,0.16,5,7
90,"Baumaschinenmechaniker/in EFZ",11,0.14,1,10
90,"Motorradmechaniker/in EFZ",11,0.14,0,11
90,"Polybauer/in (Dachdecken) EFZ",11,0.14,1,10
90,"Polydesigner/in 3D EFZ (Dekorationsgestalter)",11,0.14,7,4
94,"Lastwagenführer/in",10,0.13,0,10
94,"Metallbaukonstrukteur/in EFZ",10,0.13,0,10
94,"Reifenpraktiker/in EBA",10,0.13,0,10
94,"Strassenbaupraktiker/in EBA",10,0.13,0,10
94,"Telematiker/in EFZ",10,0.13,0,10
94,"Zahntechniker/in EFZ",10,0.13,6,4
100,"Boden-Parkettleger/in EFZ",9,0.12,0,9
100,"Chemie- und Pharmatechnologe/-login EFZ",9,0.12,2,7
100,"Fachmann/-frau Kundendialog EFZ",9,0.12,7,2
100,"Restaurationsangestellte/r EBA",9,0.12,5,4
104,"Anlehre: Gastgewerbe, Hauswirtschaft",8,0.10,4,4
104,"Anlehre: Haustechnik",8,0.10,1,7
104,"Baupraktiker/in EBA",8,0.10,0,8
104,"Gestalter/in Werbetechnik EFZ",8,0.10,8,0
104,"Hotellerieangestellte/r EBA",8,0.10,8,0
104,"Lebensmitteltechnologe/-login",8,0.10,2,6
104,"Polygraf/in (Mediengestaltung) EFZ",8,0.10,5,3
104,"Polygraf/in (Medienproduktion) EFZ",8,0.10,4,4
104,"Tierpfleger/in EFZ",8,0.10,7,1
104,"Zweiradmechaniker/in (Kleinmotorräder)",8,0.10,0,8
114,"Fachmann/-frau Bewegungs-u.Ges.heitsförderung EFZ",7,0.09,4,3
114,"Gipser/in",7,0.09,0,7
114,"Metallbaupraktiker/in EBA",7,0.09,0,7
114,"Zweiradmechaniker/in (Fahrräder)",7,0.09,0,7
118,"Anlehre: Landwirtsch., Gartenbau, Forstwirtschaft",6,0.08,0,6
118,"Anlehre: Verkauf",6,0.08,2,4
118,"Florist/in EBA",6,0.08,6,0
118,"Gärtner/in (Zierpflanzen)",6,0.08,5,1
118,"Gebäudetechnikplaner/in Sanitär EFZ",6,0.08,4,2
118,"Kosmetiker/in EFZ",6,0.08,6,0
118,"Physiklaborant/in",6,0.08,1,5
118,"Zeichner/in (Innenarchitektur) EFZ",6,0.08,0,6
118,"Zeichner/in (Landschaftsarchitektur) EFZ",6,0.08,3,3
127,"Fachmann/-frau Information u. Dokumentation EFZ",5,0.06,2,3
127,"Fahrzeugschlosser/in EFZ",5,0.06,0,5
127,"Gebäudereiniger/in EFZ",5,0.06,0,5
127,"Haustechnikplaner/in (Kälte)",5,0.06,1,4
127,"Industrielackierer/in EFZ",5,0.06,1,4
127,"Kältesystem-Monteur/-in EFZ",5,0.06,1,4
127,"Podologe/-login EFZ",5,0.06,4,1
127,"Recyclist/in EFZ",5,0.06,0,5
135,"Anlehre: Übrige Berufe",4,0.05,2,2
135,"Fahrradmechaniker/-in EFZ",4,0.05,0,4
135,"Gärtner/in (Baumschule)",4,0.05,0,4
135,"Gärtner/-in EBA (Pflanzenproduktion)",4,0.05,2,2
135,"Gebäudereiniger/in EBA",4,0.05,0,4
135,"Kunststofftechnologe/-login EFZ",4,0.05,0,4
135,"Plattenleger/in EFZ",4,0.05,0,4
135,"Polybauer/in (Sonnenschutzsysteme) EFZ",4,0.05,0,4
135,"Veranstaltungsfachmann/-frau EFZ",4,0.05,1,3
144,"Anlehre: Baugewerbe, Malerei",3,0.04,1,2
144,"Anlehre: Holzbearbeitung",3,0.04,0,3
144,"Anlehre: Postangestellte/r",3,0.04,2,1
144,"Architekturmodellbauer/in",3,0.04,1,2
144,"Bootfachwart/in",3,0.04,0,3
144,"Fleischfachassistent/in EBA",3,0.04,0,3
144,"Gärtner/in (Stauden)",3,0.04,2,1
144,"Grafiker/in EFZ",3,0.04,3,0
144,"Motorgerätemechaniker/in EFZ",3,0.04,0,3
144,"Oberflächenpraktiker/in EBA",3,0.04,0,3
144,"Plattenlegerpraktiker/in EBA",3,0.04,0,3
144,"Winzer/in EFZ",3,0.04,1,2
156,"Anlehre: Büro, Verwaltung",2,0.03,0,2
156,"Anlehre: Bürogehilfe/In",2,0.03,0,2
156,"Anlehre: Fahrzeuge",2,0.03,0,2
156,"Anlehre: Metallbearbeitung, Maschinenbau",2,0.03,0,2
156,"Anlehre: Nahrungsmittel und Getränke",2,0.03,2,0
156,"Carrosseriesattler/in",2,0.03,0,2
156,"Feinwerkoptiker/in",2,0.03,0,2
156,"Glaser/in EFZ",2,0.03,0,2
156,"Kaminfeger/in EFZ",2,0.03,1,1
156,"Lüftungsanlagenbauer/in EFZ",2,0.03,0,2
156,"Oberflächenbeschichter/in EFZ",2,0.03,0,2
156,"Orthopädie-Schuhmacher/in EFZ",2,0.03,1,1
156,"Orthopädist/in EFZ",2,0.03,1,1
156,"Systemgastronomiefachmann/-frau EFZ",2,0.03,1,1
156,"Textiltechnologe/-login (Design) EFZ",2,0.03,2,0
156,"Uhrmacher Praktiker/in",2,0.03,1,1
156,"Uhrmacher/in (Industrie)",2,0.03,0,2
156,"Weintechnologe/-login EFZ",2,0.03,1,1
174,"Anlehre: Blumenbinder/in",1,0.01,1,0
174,"Anlehre: Fahrzeugmaler/in",1,0.01,0,1
174,"Anlehre: Grafisches Gewerbe",1,0.01,0,1
174,"Anlehre: INSOS Pra",1,0.01,0,1
174,"Anlehre: Malerei",1,0.01,1,0
174,"Anlehre: Technische Berufe",1,0.01,0,1
174,"Bekleidungsgestalter/in (Modisterei)",1,0.01,1,0
174,"Bekleidungsgestalter/in (Pelznähen)",1,0.01,1,0
174,"Bootbauer/in",1,0.01,0,1
174,"Fachmann/-frau für med. techn. Radiologie",1,0.01,0,1
174,"Flexodrucker/in EFZ",1,0.01,0,1
174,"Formenbauer/in EFZ (Techn. Modellbauer/in)",1,0.01,0,1
174,"Goldschmied/in (Edelsteinfassen) EFZ",1,0.01,1,0
174,"Goldschmied/in (Goldschmieden) EFZ",1,0.01,1,0
174,"Grundbaupraktiker/in EBA",1,0.01,0,1
174,"Gussformer/in",1,0.01,0,1
174,"Holzbearbeiter/in EBA",1,0.01,0,1
174,"Holzhandwerker/in EFZ (Drechslerei)",1,0.01,0,1
174,"Laborant/in (Farbe und Lack) EFZ",1,0.01,1,0
174,"Lackierassisten/in EBA",1,0.01,0,1
174,"Milchtechnologe/-login EFZ",1,0.01,0,1
174,"Müller/-in EFZ",1,0.01,0,1
174,"Multimediagestalter/in",1,0.01,1,0
174,"Ofenbauer/in EFZ",1,0.01,0,1
174,"Pferdefachmann/-frau (Klassisches Reiten) EFZ",1,0.01,1,0
174,"Pferdefachmann/-frau (Pferdepflege) EFZ",1,0.01,1,0
174,"Pferdefachmann/-frau (Westernreiten) EFZ",1,0.01,1,0
174,"Pferdewart/in EBA",1,0.01,1,0
174,"Polybauer/in (Abdichten) EFZ",1,0.01,0,1
174,"Polybaupraktiker/in EBA",1,0.01,0,1
174,"Printmedienpraktiker/-in EBA",1,0.01,1,0
174,"Printmedienverarbeiter/in (Bindetechnik) EFZ",1,0.01,1,0
174,"Printmedienverarbeiter/in (Buchbinderei) EFZ",1,0.01,0,1
174,"Printmedienverarbeiter/in (Druckausrüstung) EFZ",1,0.01,0,1
174,"Steinbildhauer/in EFZ",1,0.01,0,1
174,"Steinmetz/in EFZ",1,0.01,0,1
174,"Textiltechnologe/-login (Verarbeitung) EFZ",1,0.01,1,0
174,"Uhrmacher/in (Rhabillage)",1,0.01,1,0
174,"Verkehrswegbauer/in: Gleisbauer/in",1,0.01,0,1
174,"Verkehrswegbauer/in: Pflästerer/in",1,0.01,0,1
